-1 -1 -1 -1 -1 -1 -1 -1 -1 -1 -1 -1 -1 -1 -1 -1 -1 -1 -1 -1 -1 -1 -1 -1 -1 -1 -1 -1 -1 -1 -1 -1 -1 -1
-1 -1 -1 -1 -1 -1 -1 -1 -1 -1 -1 14 16 15 -1 -1 -1 -1 -1 -1 -1 -1 -1 -1 -1 -1 -1 -1 -1 -1 -1 -1 -1 -1
-1 -1 -1 -1 -1 -1 14 16 16 16 16 10 1 13 -1 -1 -1 -1 -1 -1 -1 -1 -1 -1 -1 -1 -1 -1 -1 -1 -1 -1 -1 -1
-1 -1 -1 -1 -1 -1 12 0 1 2 0 1 2 13 -1 -1 -1 -1 14 16 16 16 15 -1 -1 -1 -1 -1 -1 -1 -1 -1 -1 -1
-1 -1 -1 -1 -1 14 10 1 2 0 1 2 0 11 16 15 -1 14 10 1 2 0 11 16 16 15 -1 -1 -1 -1 -1 -1 -1 -1
-1 -1 -1 -1 -1 12 1 2 0 1 2 0 1 2 0 13 -1 12 1 2 0 1 2 0 1 11 15 -1 -1 -1 -1 -1 -1 -1
-1 -1 -1 -1 -1 12 2 0 1 2 0 1 2 0 1 13 -1 12 2 0 1 2 0 1 2 0 11 16 16 15 -1 -1 -1 -1
-1 -1 -1 -1 -1 12 0 1 2 0 1 2 0 1 2 13 -1 12 0 1 2 0 1 2 0 1 2 0 1 11 15 -1 -1 -1
-1 14 15 -1 -1 5 8 2 0 1 2 0 1 2 0 13 -1 12 1 2 0 1 2 0 1 2 0 1 2 0 13 -1 -1 -1 
-1 5 6 -1 -1 -1 12 0 1 2 0 1 2 0 1 13 -1 12 2 0 1 2 0 1 2 0 1 2 0 1 13 -1 -1 -1 
-1 -1 -1 -1 -1 -1 12 1 2 0 1 2 0 1 2 11 16 10 0 1 2 0 1 2 0 1 2 0 1 2 13 -1 -1 -1
16 15 -1 -1 -1 -1 12 2 0 1 2 0 1 2 0 1 2 0 1 2 0 1 2 0 1 2 0 1 2 0 13 -1 -1 -1
1 11 15 -1 -1 -1 5 8 1 2 0 1 2 0 1 2 0 1 2 0 1 2 0 1 2 0 1 2 0 9 6 -1 -1 -1
0 1 13 -1 -1 -1 -1 5 8 2 0 1 2 0 1 2 0 1 2 0 1 2 0 1 2 0 1 9 7 6 -1 -1 -1 -1 
2 9 6 -1 -1 -1 -1 -1 12 0 1 2 0 1 2 0 9 7 8 1 2 0 1 2 0 1 2 13 -1 -1 -1 -1 -1 -1 
0 13 -1 -1 -1 -1 -1 -1 5 8 1 2 0 1 2 9 6 -1 5 8 0 1 2 0 1 2 9 6 -1 -1 -1 -1 -1 -1 
1 13 -1 -1 -1 -1 -1 -1 -1 5 7 7 7 7 7 6 -1 -1 -1 5 7 8 0 1 9 7 6 -1 -1 -1 -1 -1 -1 -1
9 6 -1 -1 -1 -1 -1 -1 -1 -1 -1 -1 -1 -1 -1 -1 -1 -1 -1 -1 -1 5 7 7 6 -1 -1 -1 -1 -1 -1 -1 -1 -1
6 -1 -1 -1 -1 -1 -1 -1 -1 -1 -1 -1 -1 -1 -1 -1 -1 -1 -1 -1 -1 -1 -1 -1 -1 -1 -1 -1 -1 -1 -1 -1 -1 -1
-1 -1 -1 -1 -1 -1 -1 -1 -1 -1 -1 -1 -1 -1 -1 -1 -1 -1 -1 -1 -1 -1 -1 -1 -1 -1 -1 -1 -1 -1 -1 -1 -1 -1
-1 -1 -1 -1 -1 -1 -1 -1 -1 -1 -1 -1 -1 -1 -1 -1 -1 -1 -1 -1 -1 -1 -1 -1 -1 -1 -1 -1 -1 -1 -1 -1 -1 -1